H,H,H,H,ST,H,H,H
B,B,W,W,W,B,B,B
B,B,W,B,W,B,B,B
B,B,W,W,W,B,B,B
B,B,B,B,B,B,B,B
B,B,B,B,B,B,B,B
